    #######
    #     ##
##### ###  ##
#       #  ##
#@$xxx. ##$ #
#  #    ## .#
##  ##  # $ #
 ##  ####.$.#
  ##        #
   ######  ##
        ####