 #######
##     # #
#  x.$.#
#  x.#.###
# #$@$$  #
#   ## # #
######   #
     #####