###############
#   ### . $  ##
#   $ x.. #$ ##
## $# ..x $  @#
##  $ . ###   #
###############