  ####
###  ####
#   @   ##
# #. .#.###
# $$$ $$$ #
###.#.#.# #
 ##       #
  ####  ###
     ####